['F', 'F', 'F', 'F', 'F', '*', '*', '*', '*', '*', 'F', 'F', '*', '*', '*', '*'],
['F', 'J', 'J', 'J', 'F', '*', '*', '*', '*', '*', 'F', 'F', '*', '*', '*', '*'],
['F', 'J', 'J', 'F', 'F', '*', '*', '*', '*', '*', 'F', 'F', '*', '*', '*', '*'],
['F', 'J', 'F', '*', '*', '*', '*', '*', '*', '*', 'F', 'F', '*', '*', '*', '*'],
['F', 'F', '*', '*', '*', '*', '*', '*', '*', '*', 'F', 'F', '*', '*', '*', '*'],
['F', '*', '*', '*', '*', '*', '*', '*', '*', '*', 'F', 'F', '*', '*', '*', '*'],
['*', '*', '*', '*', 'p', '*', '*', '*', '*', '*', 'F', 'F', '*', '*', '*', '*'],
['*', '*', '*', '*', 'F', '*', '*', '*', '*', '*', 'F', 'F', '*', '*', '*', '*'],
['J', '*', '*', '*', 'F', '*', '*', '*', '*', '*', 'F', 'F', '*', '*', '*', '*'],
['F', '*', '*', '*', 'F', '*', '*', '*', '*', '*', 'F', 'F', '+', '*', '*', '*'],
['F', '*', '*', '*', '*', 'F', '*', '*', '*', '*', '*', '*', '*', '*', '*', '*'],
['F', '*', '*', '*', '*', 'F', 'F', '*', '*', '*', '*', '*', '*', '*', '*', '*'],
['F', '*', '*', '*', 'J', '*', '*', 'F', '*', '*', '*', '*', '*', '*', '*', '*'],
['*', '*', '*', '*', 'F', '*', '*', '*', 'F', '*', '*', '*', 'F', '*', '*', 'E'],
['*', '*', '*', '*', 'F', '*', '*', '*', '*', 'J', 'J', 'F', '*', 'F', 'p', 'p'],
['p', 'p', 'p', 'p', 'p', 'p', 'p', 'p', 'p', 'p', 'p', 'p', 'p', 'p', 'p', 'p'],
